. . . . . . . . . . . . . . . . . . % 
% % % % % % % % % % % % % % % % % % A 
. . . . . . . . . . . . . . . . . % % 
% . . % . A . % . . . . . . . . % . A 
. . . . % % % . . . . . . . . . . % % 
. . . % . % . % . . . . . . . . . . . 
. . . . . . . . . . . . . . . . . . . 
. . . . . . . . . . . . . . . . . . . 
% % % % % % % . . . . . % % % % . % % 
. . . . . . % . . . . . % . . . . . . 
. . . . . . % . . . . . . . . . . . . 
. . . . . . % . . . . . . . . . . . . 
. . . . . . % . . . . . % . . . . . . 
. . . . . . % . . . . . % . . . . . . 
. . . . . % % . % % % % % . . . . . . 
. . . . . 1 b . . . . . . . . . . . . 
% % % % % % % % % % % % % % % % % % % 

